96 8
1 1 1 1 1 1 1 1 11 12 1 1 1 1 1 1 1 1 1 1 11 12 1 1 1 11 12 1 1 1 13 14 15 1 1 1 1 1 1 1 1 1 1 1 1 1 1 1 1 1 1 1 1 1 1 1 1 1 1 1 1 11 12 1 1 1 1 1 11 12 1 1 1 1 1 13 14 15 1 1 1 11 12 1 1 1 10 1 1 13 14 15 1 1 1 1 
1 1 13 14 15 1 1 1 1 1 1 1 1 1 1 1 1 11 14 15 1 1 1 1 1 1 1 1 1 1 1 1 1 1 1 1 1 11 14 15 1 1 11 12 1 1 11 14 15 1 1 1 1 11 12 1 1 1 1 1 1 1 1 1 1 1 1 1 1 1 1 1 1 1 1 1 1 1 1 1 1 1 1 1 1 1 1 1 1 1 1 1 1 1 1 1 
3 3 3 3 3 3 3 3 3 3 3 3 3 3 3 3 3 3 3 3 3 3 3 3 3 3 3 3 3 3 3 3 3 3 3 3 3 3 3 3 3 3 3 3 3 3 3 3 3 3 3 3 3 3 3 3 3 3 3 3 3 3 3 3 3 3 3 3 3 3 3 3 3 3 3 3 3 3 3 3 3 3 3 3 3 3 3 3 3 3 3 3 3 3 3 3 
4 5 6 7 8 9 4 5 6 8 9 4 5 6 7 8 8 9 4 5 7 8 9 4 5 7 8 9 4 5 5 7 9 4 5 6 7 8 9 4 5 7 8 9 4 5 6 7 9 4 5 6 7 8 9 4 5 6 7 8 9 4 5 6 7 8 9 4 5 5 6 7 8 9 4 5 6 7 8 9 4 5 6 8 8 9 4 5 6 7 8 8 9 4 5 6 
18 17 16 18 17 17 18 16 17 18 16 17 18 16 16 17 18 17 17 18 16 17 18 16 17 17 16 17 18 16 16 18 16 17 18 18 17 18 16 17 18 17 17 18 16 17 18 17 17 18 18 17 18 16 17 18 17 18 16 17 18 16 17 18 16 17 18 16 16 17 18 16 17 18 17 17 18 16 17 18 16 17 18 16 17 18 18 17 18 16 17 18 16 17 18 18
18 17 16 18 17 17 18 16 17 18 16 17 18 16 16 17 18 17 17 18 16 17 18 16 17 17 16 17 18 16 16 18 16 17 18 18 17 18 16 17 18 17 17 18 16 17 18 17 17 18 18 17 18 16 17 18 17 18 16 17 18 16 17 18 16 17 18 16 16 17 18 16 17 18 17 17 18 16 17 18 16 17 18 16 17 18 18 17 18 16 17 18 16 17 18 18
18 17 16 18 17 17 18 16 17 18 16 17 18 16 18 17 18 16 17 18 16 17 18 16 18 18 16 17 18 16 17 18 16 17 18 16 17 16 16 17 18 16 17 18 16 17 18 16 17 18 16 17 18 16 17 16 17 18 18 17 18 16 17 18 16 17 18 16 16 17 18 16 17 18 16 17 18 16 17 18 16 17 18 16 18 18 18 17 18 16 18 18 16 18 18 17
18 17 16 18 17 17 18 16 17 18 16 17 18 16 16 17 18 17 17 18 16 17 18 16 17 17 16 17 18 16 16 18 16 17 18 18 17 18 16 17 18 17 17 18 16 17 18 17 17 18 18 17 18 16 17 18 17 18 16 17 18 16 17 18 16 17 18 16 16 17 18 16 17 18 17 17 18 16 17 18 16 17 18 16 17 18 18 17 18 16 17 18 16 17 18 18