64 8
5 4 4 5 4 5 4 5 7 3 5 3 5 5 3 5 5 4 5 3 5 3 7 5 5 7 5 7 3 5 7 5 4 5 7 5 7 7 5 6 2 5 5 1 5 5 3 5 3 5 5 1 5 5 5 3 6 5 4 5 7 5 5 5 
2 2 4 3 2 5 3 7 2 7 2 2 2 4 2 6 2 2 5 2 2 2 4 2 5 4 3 2 2 7 6 5 4 2 4 2 3 2 4 2 3 2 4 2 3 2 4 2 3 2 5 3 2 5 2 3 2 2 6 7 2 4 2 2 
3 3 3 3 5 5 3 3 3 3 3 3 3 3 3 3 3 3 3 3 3 3 3 3 3 3 3 3 3 3 3 3 3 3 3 3 3 3 3 3 3 3 3 5 3 6 3 7 3 3 3 2 3 4 3 6 3 5 3 6 3 6 4 3 
4 4 6 7 7 7 6 4 5 4 4 4 4 5 6 7 6 5 4 3 2 4 2 4 4 2 4 3 4 3 4 4 7 4 6 5 4 3 2 4 5 4 4 3 4 5 4 6 4 7 4 7 6 5 4 3 2 3 4 5 6 7 6 4 
5 4 4 5 4 5 4 5 7 3 5 3 5 5 3 5 5 4 5 3 5 3 7 5 5 7 5 7 3 5 7 5 4 5 7 5 7 7 5 6 2 5 5 1 5 5 3 5 3 5 5 1 5 5 5 3 6 5 4 5 7 5 5 5 
6 6 6 6 6 6 5 6 6 6 6 6 6 6 6 6 6 6 6 6 6 6 6 6 6 6 6 6 6 6 6 6 6 7 6 6 6 6 6 7 6 6 6 6 6 6 6 6 6 6 6 6 6 5 3 6 6 6 6 6 6 6 6 6 
2 3 4 5 6 7 7 5 4 3 2 7 6 3 4 5 6 7 6 5 4 3 2 3 4 5 6 7 5 4 3 2 7 3 4 5 6 7 7 3 5 7 7 5 4 7 3 7 3 7 3 4 7 3 4 3 4 3 7 4 3 4 7 3 
8 8 8 8 8 8 8 8 8 8 8 8 8 8 8 8 8 8 8 8 8 8 8 8 8 8 8 8 8 8 8 8 8 8 8 8 8 8 8 8 8 8 8 8 8 8 8 8 8 8 8 8 8 8 8 8 8 8 8 8 8 8 8 8 
