10 64
2 3 4 5 6 7 6 5 4 3 
2 3 4 5 6 7 6 5 4 3 
2 2 4 5 4 6 5 3 7 3 
2 3 4 6 3 5 5 4 4 2 
2 4 4 5 2 4 4 2 6 3 
2 5 5 5 5 3 3 5 4 4 
2 3 3 3 6 2 2 3 5 3 
2 4 4 5 7 3 3 5 4 5 
2 3 7 3 5 4 4 4 4 3 
2 5 4 4 4 5 5 6 4 6 
2 3 5 4 3 6 7 5 3 3 
2 2 4 3 2 4 6 5 4 7 
2 2 4 5 4 6 5 3 7 3 
2 3 4 6 3 5 5 4 4 2 
2 4 4 5 2 4 4 2 6 3 
2 5 5 5 5 3 3 5 4 4 
2 3 3 3 6 2 2 3 5 3 
2 4 4 5 7 3 3 5 4 5 
2 3 7 3 5 4 4 4 4 3 
2 5 4 4 4 5 5 6 4 6 
2 3 5 4 3 6 7 5 3 3 
2 2 4 3 2 4 6 5 4 7 
2 3 4 5 6 7 6 5 4 3 
2 4 4 5 6 7 6 5 4 3 
2 3 4 5 6 7 6 5 4 3 
2 2 4 5 4 6 5 3 7 3 
2 3 4 6 3 5 5 4 4 2 
2 4 4 5 2 4 4 2 6 3 
2 5 5 5 5 3 3 5 4 4 
2 3 3 3 6 2 2 3 5 3 
2 4 4 5 7 3 3 5 4 5 
2 3 7 3 5 4 4 4 4 3 
2 5 4 4 4 5 5 6 4 6 
2 3 5 4 3 6 7 5 3 3 
2 2 4 3 2 4 6 5 4 7 
2 3 4 5 6 7 6 5 4 3 
2 3 4 5 6 7 6 5 4 3 
2 2 4 5 4 6 5 3 7 3 
2 3 4 6 3 5 5 4 4 2 
2 4 4 5 2 4 4 2 6 3 
2 5 5 5 5 3 3 5 4 4 
2 3 3 3 6 2 2 3 5 3 
2 4 4 5 7 3 3 5 4 5 
2 3 7 3 5 4 4 4 4 3 
2 5 4 4 4 5 5 6 4 6 
2 3 5 4 3 6 7 5 3 3 
2 2 4 3 2 4 6 5 4 7 
2 3 4 5 6 7 6 5 4 3 
2 2 4 5 4 6 5 3 7 3 
2 3 4 6 3 5 5 4 4 2 
2 4 4 5 2 4 4 2 6 3 
2 5 5 5 5 3 3 5 4 4 
2 3 3 3 6 2 2 3 5 3 
2 4 4 5 7 3 3 5 4 5 
2 3 7 3 5 4 4 4 4 3 
2 5 4 4 4 5 5 6 4 6 
2 3 5 4 3 6 7 5 3 3 
2 2 4 3 2 4 6 5 4 7 
2 3 4 5 6 7 6 5 4 3 
2 3 4 5 6 7 6 5 4 3 
2 3 4 5 6 7 6 5 4 3 
2 3 4 5 6 7 6 5 4 3 
2 3 4 5 6 7 6 5 4 3 
2 3 4 5 6 7 6 5 4 3 
